-------------------------
-                      *-
-                       -
-                       -
-                       -
-                       -
-                       -
-                       -
-                       -
-                       -
-                       -
-                       -
-                       -
-                       -
-                       -
-                       -
-                       -
- p                     -
-                       -
-------------------------