-------------------------
-                    *  -
-----    -----     ------
-           -----       -
-------                 -
-                       -
- ---   -------  --------
-                       -
-                       -
-                -----  -
-                       -
-     ---------         -
-                  ---  -
- -------------     -----
-                       -
-                       -
- ----  -----    --------
-                       -
--------     ------------
- p                     -
-------------------------