-------------------------
-                       -
-----    --    ----- *  -
------ -----  -----------
-                       -
- --------------------- -
-                       -
--------  -------  ------
-                       -
- --------------------- -
-                       -
----------  -------------
-                       -
- --------------------- -
-                       -
--------- ---------  ----
-                       -
- -------- --------------
- p                     -
-------------------------